BEN	B EH N
CAMERON	K AE M ER AH N
CHRYSTAL	K R IH S T AH L
FIVE	F AY V
FOUR	F AO R
GO	G OW
HELLO	HH AH L OW
HELLO(2)	HH EH L OW
HOME	HH OW M
HUNG	HH AH NG
IS	IH Z
LESLIE	L EH S L IY
MY	M AY
NAME	N EY M
NO	N OW
ONE	W AH N
ONE(2)	HH W AH N
SEB	S EH B
TABLE	T EY B AH L
THREE	TH R IY
TO	T UW
TO(2)	T IH
TO(3)	T AH
TOM	T AA M
TWO	T UW
YES	Y EH S
